20
150 8.0
20 13
68  68  68  68  68  68  68  68  68  68  68  68  68  68  68  68  68  68  68  68
68  68  68  68  68  68  68  68  68  68  68  68  68  68  68  68  68  68  68  68 
68  68  68  68  68  68  68  68  68  68  68  68  68  68  68  68  68  68  68  68
68  68  135 184 184 184 184 184 184 184 137 68  68  68  68  68  68  68  68  68
68  68  160 132 133 133 133 133 133 134 157 68  68  68  68  68  68  68  68  68
68  68  160 157 68  68  68  68  68  160 157 68  68  68  68  68  68  68  68  68
68  68  160 157 68  68  68  68  68  160 183 184 184 184 184 184 184 184 184 184
184 184 185 157 68  68  68  68  68  161 133 133 133 133 133 133 133 133 133 133 
133 133 133 162 68  68  68  68  68  68  68  68  68  68  68  68  68  68  68  68
68  68  68  68  68  68  68  68  68  68  68  68  68  68  68  68  68  68  68  68
68  68  68  68  68  68  68  68  68  68  68  68  68  68  68  68  68  68  68  68
68  68  68  68  68  68  68  68  68  68  68  68  68  68  68  68  68  68  68  68 
68  68  68  68  68  68  68  68  68  68  68  68  68  68  68  68  68  68  68  68
13
0   0   0   0   0   0   0   0   0   0   0   0   0   0   0   0   0   0   0   0 
35  43  80  80  80  80  80  80  80  40  80  80  80  40  43  80  80  42  40  35
80  80  80  80  80  43  80  80  80  42  80  80  80  80  80  38  38  41  43  35 
80  80  0   0   0   0   0   0   0   0   0   80  80  80  80  80  80  80  80  80 
80  80  0   0   0   0   0   0   0   0   0   80  80  80  80  80  40  80  80  80 
80  80  0   0   80  80  80  80  80  0   0   80  80  80  80  80  80  80  80  80 
80  80  0   0   80  80  80  80  80  0   0   0   0   0   0   0   0   0   0   0    
0   0   0   0   80  80  80  80  80  0   0   0   0   0   0   0   0   0   0   0   
0   0   0   0   80  80  80  80  80  80  80  80  80  80  80  80  80  80  80  80 
80  80  80  80  80  80  40  80  80  80  80  80  80  80  80  80  80  80  80  80 
35  35  35  35  35  35  35  35  35  35  35  35  35  35  35  35  35  35  35  35
35  35  35  35  35  35  35  35  35  35  35  35  35  35  35  35  35  35  35  35
7
-0.5 7.5 0
2.5 7.5 90
2.5 3.5 0
9.5 3.5 -90
9.5 6.5 0
19.5 6.5 0
21
1 ball 5
2 ball 5
2 ball 10
1 frog 2 2 ball 5
2 frog 10
1 plain 4
1 tank 2
3 ball 5
3 frog 5 2 ball 10
2 tank 2
2 plain 5
3 ball 10
3 frog 5 3 ball 10
3 ball 10 2 tank 5 2 plain 4 2 ball 10
2 plain 10
2 tank 10
4 ball 5
4 frog 5  ball 10
4 ball 10 2 tank 7 2 plain 5 3 ball 10 
2 plain 15
2 1.5