100
20 8.0
20 13
71  71  71  71  71  71  71  71  71  71  71  71  71  71  71  71  71  71  71  71  
71  71  71  71  71  71  71  71  71  71  71  71  71  71  71  71  71  71  71  71  
71  113 241 241 241 241 241 241 241 241 241 241 241 241 223 71  71  71  71  71  
71  158 222 1   1   1   1   1   1   1   1   1   1   2   136 71  71  71  71  71  
71  158 136 71  71  71  71  71  71  71  71  71  71  158 136 71  71  71  71  71  
71  158 136 71  71  71  71  71  71  71  71  71  71  158 136 71  71  71  71  71  
71  158 136 71  71  71  71  71  71  71  71  71  71  158 136 71  71  71  71  71  
71  158 240 241 241 223 71  71  71  71  71  71  71  158 136 71  71  71  71  71  
71  169 1   1   2   136 71  71  71  71  71  71  71  158 240 241 241 241 241 241  
71  71  71  71  158 136 71  71  71  71  71  71  71  169 1   1   1   1   1   1  
71  71  71  71  158 136 71  71  71  71  71  71  71  71  71  71  71  71  71  71  
71  71  71  71  158 136 71  71  71  71  71  71  71  71  71  71  71  71  71  71  
71  71  71  71  158 136 71  71  71  71  71  71  71  71  71  71  71  71  71  71  
13
0   0   0   0   0   0   0   0   0   0   0   0   0   0   0   0   0   0   0   0 
40  80  80  80  80  80  80  80  80  80  80  80  80  80  80  80  80  80  80  80
80  0   0   0   0   0   0   0   0   0   0   0   0   0   0   80  80  38  42  40
80  0   0   0   0   0   0   0   0   0   0   0   0   0   0   80  80  80  38  80
80  0   0   80  80  80  80  80  80  80  80  80  80  0   0   80  80  80  80  80
80  0   0   80  80  80  80  38  80  80  80  80  80  0   0   80  80  80  80  80
80  0   0   80  80  80  80  80  42  41  38  80  80  0   0   80  80  43  80  80
80  0   0   0   0   0   80  80  80  38  80  80  80  0   0   80  80  80  80  80
80  0   0   0   0   0   80  80  80  80  80  80  80  0   0   0   0   0   0   0
80  80  80  80  0   0   80  80  80  80  80  80  80  0   0   0   0   0   0   0 
80  40  80  80  0   0   0   0   0   0   0   0   0   0   0   0   0   0   0   0  
80  80  80  80  0   0   0   0   0   0   0   0   0   0   0   0   0   0   0   0  
9
3.5 14.5 0
4.5 14.5 90
4.5 7.5 180
1.5 7.5 90
1.5 2.5 0
13.5 2.5 -90
13.5 8.5 0
20.5 8.5 0
21
1 ball 5
2 ball 5
2 ball 10
1 frog 2 2 ball 5
2 frog 10
1 plain 4
1 tank 2
3 ball 5
3 frog 5 2 ball 10
2 tank 2
2 plain 5
3 ball 10
3 frog 5 3 ball 10
3 ball 10 2 tank 5 2 plain 4 2 ball 10
2 plain 10
2 tank 10
4 ball 5
4 frog 5  ball 10
4 ball 10 2 tank 7 2 plain 5 3 ball 10 
2 plain 15
1 2.0