10000
10000 50.0
20 13
71  71  71  71  71  71  71  71  71  71  71  71  71  71  71  71  71  71  71  71  
71  71  71  71  71  71  71  71  71  71  71  71  71  71  71  71  71  71  71  71  
71  71  71  71  71  71  71  71  71  71  71  71  71  71  71  71  71  71  71  71  
71  71  71  71  71  71  71  71  71  71  71  71  71  71  71  71  71  71  71  71  
71  71  71  71  71  71  71  71  71  71  71  71  71  71  71  71  71  71  71  71  
71  71  71  71  71  71  71  71  71  71  71  71  71  71  71  71  71  71  71  71  
71  71  71  71  71  71  71  71  71  71  71  71  71  71  71  71  71  71  71  71  
71  71  71  71  71  71  71  71  71  71  71  71  71  71  71  71  71  71  71  71  
71  71  71  71  71  71  71  71  71  71  71  71  71  71  71  71  71  71  71  71  
71  71  71  71  71  71  71  71  71  71  71  71  71  71  71  71  71  71  71  71  
71  71  71  71  71  71  71  71  71  71  71  71  71  71  71  71  71  71  71  71  
71  71  71  71  71  71  71  71  71  71  71  71  71  71  71  71  71  71  71  71  
71  71  71  71  71  71  71  71  71  71  71  71  71  71  71  71  71  71  71  71  
13
0   0   0   0   0   0   0   0   0   0   0   0   0   0   0   0   0   0   0   0 
80  80  80  80  80  80  38  80  80  80  80  80  80  80  80  80  80  80  80  80
80  80  80  80  80  80  38  80  80  80  80  80  80  80  80  80  80  80  80  80
80  80  80  80  80  80  38  80  80  80  80  80  80  80  80  80  80  80  80  80
80  80  80  80  80  80  38  80  80  80  80  80  80  80  80  80  80  80  80  80
80  80  80  80  80  80  38  80  80  80  80  80  80  80  80  80  80  80  80  80
80  80  80  80  80  80  38  80  80  80  80  80  80  80  80  80  80  80  80  80
80  80  80  80  80  80  38  80  80  80  80  80  80  80  80  80  80  80  80  80
80  80  80  80  80  80  38  80  80  80  80  80  80  80  80  80  80  80  80  80
80  80  80  80  80  80  38  80  80  80  80  80  80  80  80  80  80  80  80  80 
35  35  35  35  35  35  35  35  35  35  35  35  35  35  35  35  35  35  35  35
35  35  35  35  35  35  35  35  35  35  35  35  35  35  35  35  35  35  35  35
7
-0.5 7.5 0
2.5 7.5 90
2.5 3.5 0
9.5 3.5 -90
9.5 6.5 0
19.5 6.5 0
2
2 ball 100
0 1.5