150
20 3.0
20 13
68  68  68  68  68  68  68  68  68  68  68  68  68  68  68  68  68  68  68  68 
68  68  68  68  68  68  68  68  68  68  68  68  68  68  68  68  68  68  68  68
68  68  68  68  68  68  68  68  68  68  68  68  68  68  68  68  68  68  68  68
184 184 184 137 68  68  68  68  68  68  68  68  68  68  68  68  68  68  68  68
133 133 134 183 184 184 137 68  68  68  68  68  68  68  68  68  68  68  68  68
68  68  161 133 133 134 183 184 184 137 68  68  68  68  68  68  68  68  68  68
68  68  68  68  68  161 133 133 134 183 184 184 137 68  68  68  68  68  68  68
68  68  68  68  68  68  68  68  161 133 133 134 183 184 184 137 68  68  68  68
68  68  68  68  68  68  68  68  68  68  68  161 133 133 134 183 184 184 184 184
68  68  68  68  68  68  68  68  68  68  68  68  68  68  161 133 133 133 133 133
68  68  68  68  68  68  68  68  68  68  68  68  68  68  68  68  68  68  68  68
68  68  68  68  68  68  68  68  68  68  68  68  68  68  68  68  68  68  68  68
68  68  68  68  68  68  68  68  68  68  68  68  68  68  68  68  68  68  68  68
13
0   0   0   0   0   0   0   0   0   0   0   0   0   0   0   0   0   0   0   0 
80  80  80  80  80  80  80  80  80  80  80  80  80  40  43  37  37  42  40  80
80  80  80  80  80  41  80  80  80  80  80  80  80  80  80  80  38  41  43  80   
0   0   0   0   80  80  80  80  80  80  80  80  80  80  38  40  37  37  80  80
0   0   0   0   0   0   0   80  80  80  80  80  80  80  80  80  80  80  80  80 
80  80  0   0   0   0   0   0   0   0   80  80  80  80  80  80  80  80  80  80 
80  80  80  80  80  0   0   0   0   0   0   0   0   80  80  80  80  80  80  80 
80  80  80  80  80  80  80  80  0   0   0   0   0   0   0   0   80  80  80  80  
80  80  80  80  80  80  80  80  80  80  80  0   0   0   0   0   0   0   0   0 
80  80  80  80  80  80  80  80  80  80  80  80  80  80  0   0   0   0   0   0  
35  35  35  35  35  35  35  35  35  35  35  35  35  35  35  35  35  35  35  35
35  35  35  35  35  35  35  35  35  35  35  35  35  35  35  35  35  35  35  35
13
-0.5 3.5 0
2.5 3.5 -90
2.5 4.5 0
5.5 4.5 -90
5.5 5.5 0
8.5 5.5 -90
8.5 6.5 0
11.5 6.5 -90
11.5 7.5 0
14.5 7.5 -90
14.5 8.5 0
20.5 8.5 -90
21
1 ball 5
2 ball 5
2 ball 10
1 frog 2 2 ball 5
2 frog 10
1 plain 4
1 tank 2
3 ball 5
3 frog 5 2 ball 10
2 tank 2
2 plain 5
3 ball 10
3 frog 5 3 ball 10
3 ball 10 2 tank 5 2 plain 4 2 ball 10
2 plain 10
2 tank 10
4 ball 5
4 frog 5  ball 10
4 ball 10 2 tank 7 2 plain 5 3 ball 10 
2 plain 15
3 1.2