100
10
20 13
71  71  71  71  71  71  71  71  71  71  71  71  71  71  71  71  71  71  71  71
71  71  71  71  71  71  71  71  71  71  71  71  71  71  71  71  71  71  71  71 
71  71  71  71  71  71  71  71  71  71  71  71  71  71  71  71  71  71  71  71
71  71  113 241 241 241 241 241 241 241 223 71  71  71  71  71  71  71  71  71
71  71  158 222 1   1   1   1   1   2   136 71  71  71  71  71  71  71  71  71
71  71  158 136 71  71  71  71  71  158 136 71  71  71  71  71  71  71  71  71
71  71  158 136 71  71  71  71  71  158 240 241 241 241 241 241 241 241 241 241
241 241 242 136 71  71  71  71  71  169 1   1   1   1   1   1   1   1   1   1   
1   1   1   180 71  71  71  71  71  71  71  71  71  71  71  71  71  71  71  71
71  71  71  71  71  71  71  71  71  71  71  71  71  71  71  71  71  71  71  71
71  71  71  71  71  71  71  71  71  71  71  71  71  71  71  71  71  71  71  71
71  71  71  71  71  71  71  71  71  71  71  71  71  71  71  71  71  71  71  71
71  71  71  71  71  71  71  71  71  71  71  71  71  71  71  71  71  71  71  71
13
0   0   0   0   0   0   0   0   0   0   0   0   0   0   0   0   0   0   0   0 
80  80  80  80  80  80  80  80  80  80  80  80  80  40  43  37  37  42  40  80
80  80  80  80  80  41  38  80  80  80  80  80  80  80  80  80  38  41  43  80   
80  80  0   0   0   0   0   0   0   0   0   80  80  80  38  40  37  37  80  80 
80  80  0   0   0   0   0   0   0   0   0   80  80  80  80  80  80  80  80  80 
80  80  0   0   80  80  80  80  80  0   0   80  80  80  80  80  80  80  80  80 
80  80  0   0   80  80  80  80  80  0   0   0   0   0   0   0   0   0   0   0    
0   0   0   0   80  80  80  80  80  0   0   0   0   0   0   0   0   0   0   0   
0   0   0   0   80  80  80  80  80  80  80  80  80  80  80  80  80  80  80  80 
80  80  80  80  80  80  38  80  80  80  80  80  80  80  80  80  80  80  80  80 
35  35  35  35  35  35  35  35  35  35  35  35  35  35  35  35  35  35  35  35
35  35  35  35  35  35  35  35  35  35  35  35  35  35  35  35  35  35  35  35
7
0 8 0
3 8 90
3 4 270
10 4 270
10 7 270
20 7 90