100
10
20 12 0 7
71  71  71  71  71  71  71  71  71  71  71  71  71  71  71  71  71  71  71  71 
71  71  71  71  71  71  71  71  71  71  71  71  71  71  71  71  71  71  71  71
71  71  113 241 241 241 241 241 241 241 223 71  71  71  71  71  71  71  71  71
71  71  158 222 1   1   1   1   1   2   136 71  71  71  71  71  71  71  71  71
71  71  158 136 71  71  71  71  71  158 136 71  71  71  71  71  71  71  71  71
71  71  158 136 71  71  71  71  71  158 240 241 241 241 241 241 241 241 241 241
241 241 242 136 71  71  71  71  71  169 1   1   1   1   1   1   1   1   1   1   
1   1   1   180 71  71  71  71  71  71  71  71  71  71  71  71  71  71  71  71
71  71  71  71  71  71  71  71  71  71  71  71  71  71  71  71  71  71  71  71
71  71  71  71  71  71  71  71  71  71  71  71  71  71  71  71  71  71  71  71
71  71  71  71  71  71  71  71  71  71  71  71  71  71  71  71  71  71  71  71
71  71  71  71  71  71  71  71  71  71  71  71  71  71  71  71  71  71  71  71

80  80  80  80  80  80  80  80  80  80  80  80  80  80  80  80  80  80  80  80 
80  80  80  80  80  80  80  80  80  80  80  80  80  80  80  80  80  80  80  80 
80  80  80  80  80  80  80  80  80  80  80  80  80  80  80  80  80  80  80  80 
80  80  80  80  80  80  80  80  80  80  80  80  80  80  80  80  80  80  80  80 
80  80  80  80  80  80  80  80  80  80  80  80  80  80  80  80  80  80  80  80 
80  80  80  80  80  80  80  80  80  80  80  80  80  80  80  80  80  80  80  80 
80  80  80  80  80  80  80  80  80  80  80  80  80  80  80  80  80  80  80  80 
80  80  80  80  80  80  80  80  80  80  80  80  80  80  80  80  80  80  80  80 
80  80  80  80  80  80  80  80  80  80  80  80  80  80  80  80  80  80  80  80 
80  80  80  80  80  80  80  80  80  80  80  80  80  80  80  80  80  80  80  80 
80  80  80  80  80  80  80  80  80  80  80  80  80  80  80  80  80  80  80  80 
