100
10 10.0
20 13
71  71  71  71  71  71  71  71  71  71  71  71  71  71  71  71  71  71  71  71
71  71  71  71  71  71  71  71  71  71  71  71  71  71  71  71  71  71  71  71 
71  71  71  71  71  71  71  71  71  71  71  71  71  71  71  71  71  71  71  71
71  71  113 241 241 241 241 241 241 241 223 71  71  71  71  71  71  71  71  71
71  71  158 222 1   1   1   1   1   2   136 71  71  71  71  71  71  71  71  71
71  71  158 136 71  71  71  71  71  158 136 71  71  71  71  71  71  71  71  71
71  71  158 136 71  71  71  71  71  158 240 241 241 241 241 241 241 241 241 241
241 241 242 136 71  71  71  71  71  169 1   1   1   1   1   1   1   1   1   1   
1   1   1   180 71  71  71  71  71  71  71  71  71  71  71  71  71  71  71  71
71  71  71  71  71  71  71  71  71  71  71  71  71  71  71  71  71  71  71  71
71  71  71  71  71  71  71  71  71  71  71  71  71  71  71  71  71  71  71  71
71  71  71  71  71  71  71  71  71  71  71  71  71  71  71  71  71  71  71  71
71  71  71  71  71  71  71  71  71  71  71  71  71  71  71  71  71  71  71  71
13
0   0   0   0   0   0   0   0   0   0   0   0   0   0   0   0   0   0   0   0 
80  80  80  80  80  80  80  80  80  80  80  80  80  40  43  37  37  42  40  80
80  80  80  80  80  41  38  80  80  80  80  80  80  80  80  80  38  41  43  80   
80  80  0   0   0   0   0   0   0   0   0   80  80  80  38  40  37  37  80  80 
80  80  0   0   0   0   0   0   0   0   0   80  80  80  80  80  80  80  80  80 
80  80  0   0   80  80  80  80  80  0   0   80  80  80  80  80  80  80  80  80 
80  80  0   0   80  80  80  80  80  0   0   0   0   0   0   0   0   0   0   0    
0   0   0   0   80  80  80  80  80  0   0   0   0   0   0   0   0   0   0   0   
0   0   0   0   80  80  80  80  80  80  80  80  80  80  80  80  80  80  80  80 
80  80  80  80  80  80  38  80  80  80  80  80  80  80  80  80  80  80  80  80 
35  35  35  35  35  35  35  35  35  35  35  35  35  35  35  35  35  35  35  35
35  35  35  35  35  35  35  35  35  35  35  35  35  35  35  35  35  35  35  35
7
-0.5 7.5 0
2.5 7.5 90
2.5 3.5 0
9.5 3.5 -90
9.5 6.5 0
19.5 6.5 0
100
1 tank 1
2 tank 10
1 frog 10
2 ball 10
3 ball 100
4 ball 100
2 tank 30
2 plain 30