100
20 11
71  71  71  71  71  71  71  71  71  71  71  71  71  71  71  71  71  71  71  71 
71  265 266 266 266 266 266 266 266 266 268 71  71  71  71  71  71  71  71  71
71  291 66  66  66  66  66  66  66  66  293 71  71  71  71  71  71  71  71  71
71  291 66  269 20  20  20  20  270 66  293 71  71  71  71  71  71  71  71  71
71  291 66  293 71  71  71  71  291 66  294 266 266 266 266 266 266 266 266 266
266 295 66  293 71  71  71  71  291 66  66  66  66  66  66  66  66  66  66  66
66  66  66  293 71  71  71  71  19  20  20  20  20  20  20  20  20  20  20  20
20  20  20  21  71  71  71  71  71  71  71  71  71  71  71  71  71  71  71  71
71  71  71  71  71  71  71  71  71  71  71  71  71  71  71  71  71  71  71  71
71  71  71  71  71  71  71  71  71  71  71  71  71  71  71  71  71  71  71  71