10000
10000 50.0
20 13
68  68  68  68  68  68  68  68  68  68  68  68  68  68  68  68  68  68  68  68
68  68  68  68  68  68  68  68  68  68  68  68  68  68  68  68  68  68  68  68 
68  68  68  68  68  68  68  68  68  68  68  68  68  68  68  68  68  68  68  68
68  68  135 184 184 184 184 184 184 184 137 68  68  68  68  68  68  68  68  68
68  68  160 132 133 133 133 133 133 134 157 68  68  68  68  68  68  68  68  68
68  68  160 157 68  68  68  68  68  160 157 68  68  68  68  68  68  68  68  68
68  68  160 157 68  68  68  68  68  160 183 184 184 184 184 184 184 184 184 184
184 184 185 157 68  68  68  68  68  161 133 133 133 133 133 133 133 133 133 133 
133 133 133 162 68  68  68  68  68  68  68  68  68  68  68  68  68  68  68  68
68  68  68  68  68  68  68  68  68  68  68  68  68  68  68  68  68  68  68  68
68  68  68  68  68  68  68  68  68  68  68  68  68  68  68  68  68  68  68  68
68  68  68  68  68  68  68  68  68  68  68  68  68  68  68  68  68  68  68  68 
68  68  68  68  68  68  68  68  68  68  68  68  68  68  68  68  68  68  68  68
13
0   0   0   0   0   0   0   0   0   0   0   0   0   0   0   0   0   0   0   0 
80  80  80  80  80  80  80  80  80  80  80  80  80  40  43  37  37  42  40  80
80  80  80  80  80  41  38  80  80  80  80  80  80  80  80  80  38  41  43  80   
80  80  0   0   0   0   0   0   0   0   0   80  80  80  38  40  37  37  80  80 
80  80  0   0   0   0   0   0   0   0   0   80  80  80  80  80  80  80  80  80 
80  80  0   0   80  80  80  80  80  0   0   80  80  80  80  80  80  80  80  80 
80  80  0   0   80  80  80  80  80  0   0   0   0   0   0   0   0   0   0   0    
0   0   0   0   80  80  80  80  80  0   0   0   0   0   0   0   0   0   0   0   
0   0   0   0   80  80  80  80  80  80  80  80  80  80  80  80  80  80  80  80 
80  80  80  80  80  80  38  80  80  80  80  80  80  80  80  80  80  80  80  80 
35  35  35  35  35  35  35  35  35  35  35  35  35  35  35  35  35  35  35  35
35  35  35  35  35  35  35  35  35  35  35  35  35  35  35  35  35  35  35  35
7
-0.5 7.5 0
2.5 7.5 90
2.5 3.5 0
9.5 3.5 -90
9.5 6.5 0
19.5 6.5 0
2
2 ball 100
0 1.5