10000
10000 50.0
20 13
71  71  71  71  71  71  71  71  71  71  71  71  71  71  71  71  71  71  71  71  
71  71  71  71  71  71  71  71  71  71  71  71  71  71  71  71  71  71  71  71  
71  113 241 241 241 241 241 241 241 241 241 241 241 241 223 71  71  71  71  71  
71  158 222 1   1   1   1   1   1   1   1   1   1   2   136 71  71  71  71  71  
71  158 136 71  71  71  71  71  71  71  71  71  71  158 136 71  71  71  71  71  
71  158 136 71  71  71  71  71  71  71  71  71  71  158 136 71  71  71  71  71  
71  158 136 71  71  71  71  71  71  71  71  71  71  158 136 71  71  71  71  71  
71  158 240 241 241 223 71  71  71  71  71  71  71  158 136 71  71  71  71  71  
71  169 1   1   2   136 71  71  71  71  71  71  71  158 240 241 241 241 241 241  
71  71  71  71  158 136 71  71  71  71  71  71  71  169 1   1   1   1   1   1  
71  71  71  71  158 136 71  71  71  71  71  71  71  71  71  71  71  71  71  71  
71  71  71  71  158 136 71  71  71  71  71  71  71  71  71  71  71  71  71  71  
71  71  71  71  158 136 71  71  71  71  71  71  71  71  71  71  71  71  71  71  
13
0   0   0   0   0   0   0   0   0   0   0   0   0   0   0   0   0   0   0   0 
80  80  80  80  80  80  80  80  80  80  80  80  80  80  80  80  80  80  80  80
80  80  80  80  80  80  80  80  80  80  80  80  80  80  80  80  80  80  80  80
80  80  80  80  80  80  80  80  80  80  80  80  80  80  80  80  80  80  80  80
80  80  80  80  80  80  80  80  80  80  80  80  80  80  80  80  80  80  80  80
80  80  80  80  80  80  80  80  80  80  80  80  80  80  80  80  80  80  80  80
80  80  80  80  80  80  80  80  80  80  80  80  80  80  80  80  80  80  80  80
80  80  80  80  80  80  80  80  80  80  80  80  80  80  80  80  80  80  80  80
80  80  80  80  80  80  80  80  80  80  80  80  80  80  80  80  80  80  80  80
80  80  80  80  80  80  80  80  80  80  80  80  80  80  80  80  80  80  80  80 
80  80  80  80  80  80  80  80  80  80  80  80  80  80  80  80  80  80  80  80
80  80  80  80  80  80  80  80  80  80  80  80  80  80  80  80  80  80  80  80 
8
-0.5 7.5 0
2.5 7.5 90
2.5 3.5 0
9.5 3.5 -90
9.5 6.5 0
19.5 6.5 0
2
2 ball 100
0 1.5